var			desc
year		GSS YEAR FOR THIS RESPONDENT
id			RESPONDNT ID NUMBER
wrkstat		LABOR FRCE STATUS
hrs1		NUMBER OF HOURS WORKED LAST WEEK
hrs2		NUMBER OF HOURS USUALLY WORK A WEEK
evwork		EVER WORK AS LONG AS ONE YEAR
wrkslf		R SELF-EMP OR WORKS FOR SOMEBODY
wrkgovt		GOVT OR PRIVATE EMPLOYEE
occ80		RS CENSUS OCCUPATION CODE (1980)
prestg80	RS OCCUPATIONAL PRESTIGE SCORE  (1980)
indus80		RS INDUSTRY CODE   (1980)
marital		MARITAL STATUS
agewed		AGE WHEN FIRST MARRIED
divorce		EVER BEEN DIVORCED OR SEPARATED
widowed		EVER BEEN WIDOWED
spwrksta	SPOUSE LABOR FORCE STATUS
sphrs1		NUMBER OF HRS SPOUSE WORKED LAST WEEK
sphrs2		NO. OF HRS SPOUSE USUALLY WORKS A WEEK
spevwork	SPOUSE EVER WORK AS LONG AS A YEAR
spwrkslf	SPOUSE SELF-EMP. OR WORKS FOR SOMEBODY
spocc80		SPOUSE CENSUS OCCUPATION CODE (1980)
sppres80	SPOUSES OCCUPATIONAL PRESTIGE SCORE (1980)
spind80		SPOUSES INDUSTRY CODE (1980)
pawrkslf	FATHER SELF-EMP. OR WORKED FOR SOMEBODY
paocc80		FATHERS CENSUS OCCUPATION CODE (1980)
papres80	FATHERS OCCUPATIONAL PRESTIGE SCORE (1980)
paind80		FATHERS INDUSTRY CODE (1980)
maocc80		MOTHERS CENSUS OCCUPATION CODE (1980)
mapres80	MOTHERS OCCUPATIONAL PRESTIGE SCORE (1980)
mawrkslf	MOTHER SELF-EMP. OR WORKED FOR SOMEBODY
maind80		MOTHERS INDUSTRY CODE (1980)
sibs		NUMBER OF BROTHERS AND SISTERS
childs		NUMBER OF CHILDREN
age			AGE OF RESPONDENT
agekdbrn	R'S AGE WHEN 1ST CHILD BORN
educ		HIGHEST YEAR OF SCHOOL COMPLETED
paeduc		HIGHEST YEAR SCHOOL COMPLETED, FATHER
maeduc		HIGHEST YEAR SCHOOL COMPLETED, MOTHER
speduc		HIGHEST YEAR SCHOOL COMPLETED, SPOUSE
degree		RS HIGHEST DEGREE
padeg		FATHERS HIGHEST DEGREE
madeg		MOTHERS HIGHEST DEGREE
spdeg		SPOUSES HIGHEST DEGREE
sex			RESPONDENTS SEX
race		RACE OF RESPONDENT
res16		TYPE OF PLACE LIVED IN WHEN 16 YRS OLD
reg16		REGION OF RESIDENCE, AGE 16
mobile16	GEOGRAPHIC MOBILITY SINCE AGE 16
family16	LIVING WITH PARENTS WHEN 16 YRS OLD
famdif16	REASON NOT LIVING WITH PARENTS
mawrkgrw	MOTHERS EMPLOYMENT WHEN R WAS 16
incom16		RS FAMILY INCOME WHEN 16 YRS OLD
born		WAS R BORN IN THIS COUNTRY
parborn		WERE RS PARENTS BORN IN THIS COUNTRY
granborn	HOW MANY GRANDPARENTS BORN OUTSIDE U.S.
hompop		NUMBER OF PERSONS IN HOUSEHOLD
babies		HOUSEHOLD MEMBERS LESS THAN 6 YRS OLD
preteen		HOUSEHOLD MEMBERS 6 THRU 12 YRS OLD
teens		HOUSEHOLD MEMBERS 13 THRU 17 YRS OLD
adults		HOUSEHOLD MEMBERS 18 YRS AND OLDER
unrelat		NUMBER IN HOUSEHOLD NOT RELATED
earnrs		HOW MANY IN FAMILY EARNED MONEY
income		TOTAL FAMILY INCOME
rincome		RESPONDENTS INCOME
income06	TOTAL FAMILY INCOME
rincom06	RESPONDENTS INCOME
region		REGION OF INTERVIEW
xnorcsiz	EXPANDED N.O.R.C. SIZE CODE
srcbelt		SRC BELTCODE
size		SIZE OF PLACE IN 1000S
partyid		POLITICAL PARTY AFFILIATION
vote00		DID R VOTE IN 2000 ELECTION
pres00		VOTE FOR GORE, BUSH, NADER
if00who		WHO WOULD R HAS VOTED FOR IN 2000 ELECTION
vote04		DID R VOTE IN 2004 ELECTION
pres04		VOTE FOR KERRY, BUSH, NADER
if04who		WHO WOULD R HAS VOTED FOR IN 2004 ELECTION
polviews	THINK OF SELF AS LIBERAL OR CONSERVATIVE
natspac		SPACE EXPLORATION PROGRAM
natenvir	IMPROVING & PROTECTING ENVIRONMENT
natheal		IMPROVING & PROTECTING NATIONS HEALTH
natcity		SOLVING PROBLEMS OF BIG CITIES
natcrime	HALTING RISING CRIME RATE
natdrug		DEALING WITH DRUG ADDICTION
nateduc		IMPROVING NATIONS EDUCATION SYSTEM
natrace		IMPROVING THE CONDITIONS OF BLACKS
natarms		MILITARY, ARMAMENTS, AND DEFENSE
nataid		FOREIGN AID
natfare		WELFARE
natroad		HIGHWAYS AND BRIDGES
natsoc		SOCIAL SECURITY
natmass		MASS TRANSPORTATION
natpark		PARKS AND RECREATION
natchld		ASSISTANCE FOR CHILDCARE
natsci		SUPPORTING SCIENTIFIC RESEARCH
natspacy	SPACE EXPLORATION -- VERSION Y
natenviy	THE ENVIRONMENT -- VERSION Y
nathealy	HEALTH -- VERSION Y
natcityy	ASSISTANCE TO BIG CITIES -- VERSION Y
natcrimy	LAW ENFORCEMENT -- VERISON Y
natdrugy	DRUG REHABILITATION -- VERSION Y
nateducy	EDUCATION -- VERSION Y
natracey	ASSISTANCE TO BLACKS -- VERSION Y
natarmsy	NATIONAL DEFENSE -- VERSION Y
nataidy		ASSISTANCE TO OTHER COUNTRIES -- VER Y
natfarey	ASSISTANCE TO THE POOR -- VERSION Y
eqwlth		SHOULD GOVT REDUCE INCOME DIFFERENCES
tax			RS FEDERAL INCOME TAX
spkath		ALLOW ANTI-RELIGIONIST TO SPEAK
colath		ALLOW ANTI-RELIGIONIST TO TEACH
libath		ALLOW ANTI-RELIGIOUS BOOK IN LIBRARY
spkrac		ALLOW RACIST TO SPEAK
colrac		ALLOW RACIST TO TEACH
librac		ALLOW RACISTS BOOK IN LIBRARY
spkcom		ALLOW COMMUNIST TO SPEAK
colcom		SHOULD COMMUNIST TEACHER BE FIRED
libcom		ALLOW COMMUNISTS BOOK IN LIBRARY
spkmil		ALLOW MILITARIST TO SPEAK
colmil		ALLOW MILITARIST TO TEACH
libmil		ALLOW MILITARISTS BOOK IN LIBRARY
spkhomo		ALLOW HOMOSEXUAL TO SPEAK
colhomo		ALLOW HOMOSEXUAL TO TEACH
libhomo		ALLOW HOMOSEXUALS BOOK IN LIBRARY
cappun		FAVOR OR OPPOSE DEATH PENALTY FOR MURDER
gunlaw		FAVOR OR OPPOSE GUN PERMITS
courts		COURTS DEALING WITH CRIMINALS
grass		SHOULD MARIJUANA BE MADE LEGAL
relig		RS RELIGIOUS PREFERENCE
denom		SPECIFIC DENOMINATION
other		OTHER PROTESTANT DENOMINATIONS
jew			WHAT SORT OF JEW R IS
fund		HOW FUNDAMENTALIST IS R CURRENTLY
attend		HOW OFTEN R ATTENDS RELIGIOUS SERVICES
reliten		STRENGTH OF AFFILIATION
postlife	BELIEF IN LIFE AFTER DEATH
pray		HOW OFTEN DOES R PRAY
popespks	POPE IS INFALLIBLE ON MATTERS OF FAITH OR MORALS
sprel		SPOUSES RELIGIOUS PREFERENCE
relig16		RELIGION IN WHICH RAISED
denom16		DENOMINATION IN WHICH R WAS RAISED
oth16		OTHER PROTESTANT DENOMINATIONS
jew16		WHAT SORT OF JEW R WAS AT AGE 16
fund16		HOW FUNDAMENTALIST WAS R AT AGE 16
spden		SPECIFIC DENOMINATION, SPOUSE
spother		OTHER PROTESTANT DENOMINATIONS
spjew		WHAT SORT OF JEW IS RS SPOUSE CURRENTLY
spfund		HOW FUNDAMENTALIST IS SPOUSE CURRENTLY
prayer		BIBLE PRAYER IN PUBLIC SCHOOLS
bible		FEELINGS ABOUT THE BIBLE
racopen		VOTE ON OPEN HOUSING LAW
raclive		ANY OPP. RACE IN NEIGHBORHOOD
rachome		OPP. RACE HOME FOR DINNER RECENTLY
affrmact	FAVOR PREFERENCE IN HIRING BLACKS
wrkwayup	BLACKS OVERCOME PREJUDICE WITHOUT FAVORS
closeblk	HOW CLOSE FEEL TO BLACKS
closewht	HOW CLOSE FEEL TO WHITES
happy		GENERAL HAPPINESS
hapmar		HAPPINESS OF MARRIAGE
health		CONDITION OF HEALTH
life		IS LIFE EXCITING OR DULL
helpful		PEOPLE HELPFUL OR LOOKING OUT FOR SELVES
fair		PEOPLE FAIR OR TRY TO TAKE ADVANTAGE
trust		CAN PEOPLE BE TRUSTED
confinan	CONFID IN BANKS & FINANCIAL INSTITUTIONS
conbus		CONFIDENCE IN MAJOR COMPANIES
conclerg	CONFIDENCE IN ORGANIZED RELIGION
coneduc		CONFIDENCE IN EDUCATION
confed		CONFID. IN EXEC BRANCH OF FED GOVT
conlabor	CONFIDENCE IN ORGANIZED LABOR
conpress	CONFIDENCE IN PRESS
conmedic	CONFIDENCE IN MEDICINE
contv		CONFIDENCE IN TELEVISION
conjudge	CONFID. IN UNITED STATES SUPREME COURT
consci		CONFIDENCE IN SCIENTIFIC COMMUNITY
conlegis	CONFIDENCE IN CONGRESS
conarmy		CONFIDENCE IN MILITARY
obey		TO OBEY
popular		TO BE WELL LIKED OR POPULAR
thnkself	TO THINK FOR ONES SELF
workhard	TO WORK HARD
helpoth		TO HELP OTHERS
socrel		SPEND EVENING WITH RELATIVES
socommun	SPEND EVENING WITH NEIGHBOR
socfrend	SPEND EVENING WITH FRIENDS
socbar		SPEND EVENING AT BAR
aged		SHOULD AGED LIVE WITH THEIR CHILDREN
weekswrk	WEEKS R. WORKED LAST YEAR
partfull	WAS R'S WORK PART-TIME OR FULL-TIME?
anomia7		OFFICIALS NOT INTERESTED IN AVERAGE MAN
joblose		IS R LIKELY TO LOSE JOB
jobfind		COULD R FIND EQUALLY GOOD JOB
satjob		JOB OR HOUSEWORK
richwork	IF RICH, CONTINUE OR STOP WORKING
jobinc		HIGH INCOME
jobsec		NO DANGER OF BEING FIRED
jobhour		SHORT WORKING HOURS
jobpromo	CHANCES FOR ADVANCEMENT
jobmeans	WORK IMPORTANT AND FEEL ACCOMPLISHMENT
class		SUBJECTIVE CLASS IDENTIFICATION
rank		RS SELF RANKING OF SOCIAL POSITION
satfin		SATISFACTION WITH FINANCIAL SITUATION
finalter	CHANGE IN FINANCIAL SITUATION
finrela		OPINION OF FAMILY INCOME
wksub		DOES R OR SPOUSE HAVE SUPERVISOR
wksubs		DOES SUPERVISOR HAVE SUPERVISOR
wksup		DOES R OR SPOUSE SUPERVISE ANYONE
wksups		DOES SUBORDINATE SUPERVISE ANYONE
unemp		EVER UNEMPLOYED IN LAST TEN YRS
union		DOES R OR SPOUSE BELONG TO UNION
getahead	OPINION OF HOW PEOPLE GET AHEAD
parsol		RS LIVING STANDARD COMPARED TO PARENTS
kidssol		RS KIDS LIVING STANDARD COMPARED TO R
fepol		WOMEN NOT SUITED FOR POLITICS
abdefect	STRONG CHANCE OF SERIOUS DEFECT
abnomore	MARRIED--WANTS NO MORE CHILDREN
abhlth		WOMANS HEALTH SERIOUSLY ENDANGERED
abpoor		LOW INCOME--CANT AFFORD MORE CHILDREN
abrape		PREGNANT AS RESULT OF RAPE
absingle	NOT MARRIED
abany		ABORTION IF WOMAN WANTS FOR ANY REASON
chldidel	IDEAL NUMBER OF CHILDREN
pillok		BIRTH CONTROL TO TEENAGERS 14-16
sexeduc		SEX EDUCATION IN PUBLIC SCHOOLS
divlaw		DIVORCE LAWS
premarsx	SEX BEFORE MARRIAGE
teensex		SEX BEFORE MARRIAGE -- TEENS 14-16
xmarsex		SEX WITH PERSON OTHER THAN SPOUSE
homosex		HOMOSEXUAL SEX RELATIONS
pornlaw		FEELINGS ABOUT PORNOGRAPHY LAWS
xmovie		SEEN X-RATED MOVIE IN LAST YEAR
spanking	FAVOR SPANKING TO DISCIPLINE CHILD
letdie1		ALLOW INCURABLE PATIENTS TO DIE
suicide1	SUICIDE IF INCURABLE DISEASE
suicide2	SUICIDE IF BANKRUPT
suicide3	SUICIDE IF DISHONORED FAMILY
suicide4	SUICIDE IF TIRED OF LIVING
polhitok	EVER APPROVE OF POLICE STRIKING CITIZEN
polabuse	CITIZEN SAID VULGAR OR OBSCENE THINGS
polmurdr	CITIZEN QUESTIONED AS MURDER SUSPECT
polescap	CITIZEN ATTEMPTING TO ESCAPE CUSTODY
polattak	CITIZEN ATTACKING POLICEMAN WITH FISTS
fear		AFRAID TO WALK AT NIGHT IN NEIGHBORHOOD
owngun		HAVE GUN IN HOME
pistol		PISTOL OR REVOLVER IN HOME
shotgun		SHOTGUN IN HOME
rifle		RIFLE IN HOME
rowngun		DOES GUN BELONG TO R
hunt		DOES R OR SPOUSE HUNT
news		HOW OFTEN DOES R READ NEWSPAPER
tvhours		HOURS PER DAY WATCHING TV
phone		DOES R HAVE TELEPHONE
coop		RS ATTITUDE TOWARD INTERVIEW
comprend	RS UNDERSTANDING OF QUESTIONS
form		FORM OF SPLIT QUESTIONNAIRE ASKED
fechld		MOTHER WORKING DOESNT HURT CHILDREN
fepresch	PRESCHOOL KIDS SUFFER IF MOTHER WORKS
fefam		BETTER FOR MAN TO WORK, WOMAN TEND HOME
racdif1		DIFFERENCES DUE TO DISCRIMINATION
racdif2		DIFFERENCES DUE TO INBORN DISABILITY
racdif3		DIFFERENCES DUE TO LACK OF EDUCATION
racdif4		DIFFERENCES DUE TO LACK OF WILL
draft		RETURN TO THE DRAFT?
helppoor	SHOULD GOVT IMPROVE STANDARD OF LIVING?
helpnot		SHOULD GOVT DO MORE OR LESS?
helpsick	SHOULD GOVT HELP PAY FOR MEDICAL CARE?
helpblk		SHOULD GOVT AID BLACKS?
god			RS CONFIDENCE IN THE EXISTENCE OF GOD
reborn		HAS R EVER HAD A 'BORN AGAIN' EXPERIENCE
savesoul	TRIED TO CONVINCE OTHERS TO ACCEPT JESUS
punsin		R AGREES THAT SINNERS MUST BE PUNISHED
blkwhite	R AGREES RIGHT & WRONG NOT BLACK & WHITE
rotapple	R AGREES IMMORAL PERSON CORRUPTS SOCIETY
permoral	R AGREES THAT MORALITY A PERSONAL MATTER
wlthwhts	RICH - POOR
wlthblks	RICH - POOR
workwhts	HARD WORKING - LAZY
workblks	HARD WORKING - LAZY
intlwhts	UNINTELLIGENT -INTELLIGENT
intlblks	UNINTELLIGENT - INTELLIGENT
liveblks	NEIGHBORHOOD HALF BLACK
livewhts	R FAVOR LIVING IN HALF WHITE NEIGHBORHOOD
marblk		CLOSE RELATIVE MARRY BLACK
marasian	CLOSE RELATIVE MARRY ASIAN
marhisp		CLOSE RELATIVE MARRY HISPANIC
marwht		R FAVOR CLOSE RELATIVE MARRYING WHITE PERSON
racwork		RACIAL MAKEUP OF WORKPLACE
discaff		WHITES HURT BY AFF. ACTION
trtasian	NUMBER OF ASIAN R TRUST
trtattnd	PROPORTION OF REGULAR CHURCH ATTENDEE R TRUST
trtblack	NUMBER OF BLACK R TRUST
trtbrnda	NUMBER OF  BRENDA R TRUST
trtchild	NUMBER OF CHILD CARE WORKER R TRUST
trtcohab	NUMBER OF COHABITING PPL R TRUST
trtcon		NUMBER OF STRONG CONSERVATIVE  R TRUST
trtcops		NUMBER OF POLICE OFFICER R TRUST
trtdems		PROPORTION OF DEMOCRAT R TRUST
trtelecs	NUMBER OF ELECTRICIAN R TRUST
trtgay		NUMBER OF GAY R TRUST
trtgoatt	NUMBER OF CHURCH ATTENDEE  R TRUST
trthisp		NUMBER OF HISPANIC R TRUST
trthome		NUMBER OF PPL OWNING SECOND HOME  R TRUST
trtjans		NUMBER OF JANITOR R TRUST
trtjose		NUMBER OF  JOSE R TRUST
trtkaren	NUMBER OF KAREN R TRUST
trtkeith	NUMBER OF  KEITH R TRUST
trtkevin	NUMBER OF KEVIN R TRUST
trtlaws		NUMBER OF LAWYER R TRUST
trtlib		NUMBER OF STRONG LIBERAL  R TRUST
trtlinda	NUMBER OF  LINDA R TRUST
trtmaria	NUMBER OF  MARIA R TRUST
trtmark		NUMBER OF  MARK R TRUST
trtmils		NUMBER OF PPL IN MILITARY SERVICE R TRUST
trtmyrac	PROPORTION OF SAME RACE AS R AMONG PPL R TRUST
trtnoatt	NUMBER OF NON CHURCH ATTENDEE  R TRUST
trtprisn	NUMBER OF PPL IN PRISON  R TRUST
trtrachl	NUMBER OF  RACHEL R TRUST
trtreps		PROPORTION OF REPUBLICAN R TRUST
trtshawn	NUMBER OF SHAWN R TRUST
trtsocs		NUMBER OF SOCIAL WORKER R TRUST
trtunemp	NUMBER OF PPL UNEMPLOYED R TRUST
trtwhite	NUMBER OF WHITE R TRUST
fejobaff	FOR OR AGAINST PREFERENTIAL HIRING OF WOMEN
discaffm	A MAN WON'T GET A JOB OR PROMOTION
discaffw	A WOMAN WON'T GET A JOB OR PROMOTION
fehire		SHOULD HIRE AND PROMOTE WOMEN
probfix1	FIRST MENTION OF PROBLEM
probfix2	SECOND MENTION OF PROBLEM
probfix3	THIRD MENTION OF PROBLEM
probhlp1	FIRST MENTION TO HELP PROBLEM
probhlp2	SECOND MENTION TO HELP PROBLEM
probhlp3	THIRD MENTION TO HELP PROBLEM
vigversn	VIGNETTE VERSION NUMBER
seriousp	How serious X s situation is
charactr	How likely X s stuation caused by Bad Character
imbalnce	How likely X s stuation caused by Imbalance in Brain
wayraise	How likely X s stuation caused by the Way Raised
stresses	How likely X s stuation caused by Stress
genetics	How likely X s stuation caused by Genetic Problem
godswill	How likely X s stuation caused by God s Will
upsdowns	How likely X is experiencing Normal Ups-and-Downs of Life
breakdwn	How likely X is experiencing Nervous Breakdown
mentlill	How likely X is experiencing Mental Illness
physill		How likely X is experiencing Physical Illness
dectreat	How Able Is X to Decide Receive Treatment
decmoney	How Able Is X to Decide Managing Own Money
imprvown	How Likely X s Situation will improve on its own
imprvtrt	How Likely X s Situation will improve with treatment
vignei		How Willing R Would Have X as a Neighbor
vigsoc		How Willing R Would Spend Time Socializing with X
vigfrnd		How Willing R Would Make Friends with X
vigwork		How Willing R Would Work Closely with X on a Job
viggrp		How Willing R Would Have a Group Home for X
vigmar		How Willing R Would have X Marry in Rs Family
hurtoth		How Likely X Violent toward Other People
hurtself	How Likely X Violent toward Oneself
tlkfam		X Should Talk to Family and Friends
tlkclrgy	X Should Talk to Religious Leader
meddoc		X Should Go to General Medical Doctor for Help
mentldoc	X Should Go to Phychiatrist for Help
mentloth	X Should Go to Other Mental Health Professional for Help
sphealer	X Should Go to Spiritual Healer for Help
selfhelp	X Should Join a Self-Group with Similar Problem
otcmed		X Should Take Non-Prescription Medication
rxmed		X Should Take Prescription Medication
mentlhos	X Should Check into a Mental Hospital
ortlkfm		IN WHAT ORDER TALK THINGS OVER WITH FAMILY & FRIENDS
ortlkclr	IN WHAT ORDER TALK TO A MINISTER, PRIEST, RABBI ETC
ormeddoc	IN WHAT ORDER GO TO A GENERAL MEDICAL DOCTOR
ormntldc	IN WHAT ORDER GO TO A PSYCHIATRIST FOR HELP
ormntlot	IN WHAT ORDER GO TO A THERAPIST, OR COUNSELOR
orhealer	IN WHAT ORDER GO TO A SPIRITUAL OR A NATURAL HEALER
orslfhlp	IN WHAT ORDER JOIN A SELF-HELP GROUP
orotcmed	IN WHAT ORDER TAKE NON-PRESCRIPTION MEDICATION
orrxmed		IN WHAT ORDER TAKE PRESCRIPTION MEDICATION
ormntlhs	IN WHAT ORDER CHECK INTO A MENTAL HOSPITAL
mustdoc		X Should be Forced to be Examined at a Clinic by Law
mustmed		X Should be Forced to Take Prescribed Medication by Law
musthosp	X should be Admitted to be Hospitalized for Treatment by Law
dangrslf	X should be Admitted to be Hospitalized for Treatment if Dangerous to X
dangroth	X should be Admitted to be Hospitalized for Treatment if Dangerous to Others
medcare1	Who R Thinks Should be Most Responsible for Cost of Xs Medical Care
medcare2	Who R Thinks Should be Next Most Responsible for Cost of Xs Medical Care
spmentl		GOVT SPENDING ON HEALTH
govmentl	SHOULD GOVT PROVIDE HEALTH CARE FOR MENTAL ILLNESS
rellife		TRY TO CARRY BELIEFS INTO OTHER DEALINGS
relpersn	R CONSIDER SELF A RELIGIOUS PERSON
sprtprsn	R CONSIDER SELF A SPIRITUAL PERSON
relexp		HAVE RELIGIOUS EXPERIENCE CHANGED LIFE
psycmed1	PSYCHIATRIC MEDICINE IS HARMFUL TO THE BODY
psycmed3	TAKING THESE MEDICINE INTERFERES W DAILY ACT
psycmed4	HELPS PEOPLE DEAL W DAY TO DAY STRESSES
psycmed5	MAKES THINGS EASIER IN RELATIONS
psycmed6	THESE MEDICATIONS HELP CONTROL SYMPTOMS
psycmed7	HELPS PEOPLE FEEL BETTER ABOUT THEMSELVES
usepsyc1	WILL TAKE MEDICINE BECAUSE PERSONAL TROUBLE
usepsyc2	WILL TAKE MEDICINE BECAUSE CANT COPE W STRESS
usepsyc3	WILL TAKE MEDICINE BECAUSE FEELING DEPRESSED
usepsyc4	WILL TAKE MEDICINE BECAUSE INTENSE FEAR
doc15		DOCTOR NOT REALLY CARE ME AS A PERSON
doc16		DOCTORS JUDGEMENT TRUSTED
doc18		DOCTOR PUT MEDICAL NEEDS ABOVE ALL OTHER
doc19		DOCTOR A REAL EXPERT IN TAKING CARE PROBLEM
doc20		DOCTOR TELL ME IF A MISTAKE WAS MADE
prozac		HAVE YOU EVER HEARD OF PROZAC
usedproz	HAVE YOU EVER TAKEN PROZAC
knwnproz	HAVE YOU KNOWN ANYONE WHO TOOK PROZAC
prozfor1	WHAT CAN YOU TELL ME ABOUT PROZAC IS USED FOR
prozfor2	WHAT CAN YOU TELL ME ABOUT PROZAC IS USED FOR
prozfor3	WHAT CAN YOU TELL ME ABOUT PROZAC IS USED FOR
proz1		PROZAC IS HARMFUL TO THE BODY
proz3		TAKING PROZAC INTERFERES WITH DAILY ACTIVITIES
proz4		TAKING PROZAC HELPS PEOPLE DEAL WITH STRESS
proz5		TAKING PROZAC MAKES RELATIONS EASIER
proz6		PROZAC HELPS PEOPLE CONTROL THEIR SYMPTOMS
proz7		PROZAC MAKES PEOPLE FEEL BETTER ABOUT THEMSELVES
proz8		PROZAC SHOULD BE TAKEN TO ENHANCE PERSONALITIES
proz9		PROZAC IS FOR THOSE DIAGNOSED WITH PRESSION
prozslf1	TAKE PROZAC IF TROUBLE IN PERSONAL LIFE
prozslf2	TAKE PROZAC IF CANT COPE WITH STRESSES
prozslf3	TAKE PROZAC IF FEEL DEPRESSED SLEEPLESS
prozslf4	TAKE PROZAC IF INTENSE FEAR LOSING CONTROL
othlang		CAN R SPEAK LANGUAGE OTHER THAN ENGLISH
othlang1	WHAT OTHER LANGUAGES DOES R SPEAK
othlang2	WHAT OTHER LANGUAGES DOES R SPEAK
spklang		HOW WELL DOES R SPEAK OTHER LANGUAGE
getlang		WHERE DID R LEARN OTHER LANGUAGE
othhome		R SPEAKS OTHER LANGUAGE AT HOME
betrlang	Which language R speaks more fluent
spklangw	How well R speaks the language in BETRLANG
wwwhr		WWW HOURS PER WEEK
wwwmin		WWW MINUTES PER WEEK
wrktype		WORK ARRANGEMENT AT MAIN JOB
yearsjob	TIME AT CURRENT JOB
waypaid		HOW PAID IN MAIN JOB
wrksched	USUAL WORK SCHEDULE
moredays	DAYS PER MONTH R WORK EXTRA HOURS
mustwork	MANDATORY TO WORK EXTRA HOURS
chngtme		HOW OFTEN R ALLOWED CHANGE SCHEDULE
wrkhome		HOW OFTEN R WORK AT HOME
whywkhme	USUAL REASON R WORK AT HOME
famwkoff	HOW HARD TO TAKE TIME OFF
wkvsfam		HOW OFTEN JOB INTERFERE FAM LIFE
famvswk		HOW OFTEN FAM LIFE INTERFERE JOB
hrsrelax	HOURS PER DAY R HAVE TO RELAX
secondwk	R HAS JOB OTHER THAN MAIN
learnnew	JOB REQUIRES R TO LEARN NEW THINGS
workfast	JOB REQUIRES R TO WORK FAST
workdiff	R DOES NUMEROUS THINGS ON JOB
lotofsay	R HAS LOT OF SAY IN JOB
wktopsat	SATISFACTION COMES FROM WORK
overwork	R HAS TOO MUCH WORK TO DO WELL
knowwhat	R KNOW WHAT'S EXPECTED ON JOB
myskills	JOB ALLOWS R USE OF SKILLS
respect		R TREATED WITH RESPECT AT WORK
trustman	R TRUST MANAGEMENT AT WORK
safetywk	WORKER SAFETY PRIORITY AT WORK
safefrst	NO SHORTCUTS ON WORKER SAFETY
teamsafe	MGT AND EMPLOYEES WORK TOGETHER RE SAFETY
safehlth	SAFETY AND HEALTH CONDITION GOOD AT WORK
proudemp	R PROUD TO WORK FOR EMPLOYER
prodctiv	WORK CONDITIONS ALLOW PRODUCTIVITY
wksmooth	WORKPLACE RUNS IN SMOOTH MANNER
trdunion	WORKERS NEED STRONG UNIONS
partteam	R WORK AS PART OF A TEAM
wkdecide	HOW OFTEN R TAKE PART IN DECISIONS
setthngs	HOW OFTEN R SET WAY THINGS DONE
toofewwk	HOW OFTEN NOT ENOUGH STAFF
promteok	RS CHANCES FOR PROMOTION GOOD
opdevel		OPPORTUNITY TO DEVELOP MY ABILITIES
hlpequip	ENOUGH HELP AND EQUIP TO GE THE JOB DONE
haveinfo	ENOUGH INFO TO GET THE JOB DONE
wkfreedm	A LOT OF FREEDOM TO DECIDE HOW TO DO JOB
fringeok	FRINGE BENEFITS ARE GOOD
supcares	SUPERVISOR CONCERNED ABOUT WELFARE
condemnd	R FREE FROM CONFLICTING DEMANDS
promtefr	PROMOTIONS ARE HANDLED FAIRLY
cowrkint	COWORKERS TAKE A PERSONAL INTEREST IN R
jobsecok	THE JOB SECURITY IS GOOD
suphelp		SUPERVISOR HELPFUL TO R IN GETTING JOB DONE
wrktime		R HAS ENOUGH TIME TO GET THE JOB DONE
cowrkhlp	COWORKERS CAN BE RELIED ON WHEN R NEEDS HELP
trainops	R HAVE THE TRAINING OPPORTUNITIES
manvsemp	RELATIONS BW MANAGEMENT AND EMPLOYEES
hvylift		R DO REPEATED LIFTING
handmove	R PERFORM FORCEFUL HAND MOVEMENTS
wkpraise	R ARE LIKELY TO BE PRAISED BY SUPERVISOR
wkbonus		R ARE LIKELY TO GET A BONUS OR PAY INCREASE
fairearn	HOW FAIR IS WHAT R EARN ON THE JOB
rincblls	INCOME ALONE IS ENOUGH
laidoff		R WERE LAID OFF MAIN JOB LAST YEAR
jobfind1	HOW EASY FOR R TO FIND A SAME JOB
trynewjb	HOW LIKELY R MAKE EFFORT FOR NEW JOB NEXT YEAR
wkageism	R FEEL DISCRIMINATED BECAUSE OF AGE
wkracism	R FEEL DISCRIMINATED BECAUSE OF RACE
wksexism	R FEEL DISCRIMINATED BECAUSE OF GENDER
wkharsex	R SEXUALLY HARASSED ON THE JOB LAST 12 MONTHS
wkharoth	R THREATENED ON THE JOB LAST 12 MONTHS
health1		RS HEALTH IN GENERAL
physhlth	DAYS OF POOR PHYSICAL HEALTH PAST 30 DAYS
mntlhlth	DAYS OF POOR MENTAL HEALTH PAST 30 DAYS
hlthdays	DAYS OF ACTIVITY LIMITATION PAST 30 DAYS
usedup		HOW OFTEN DURING PAST MONTH R FELT USED UP
backpain	R HAD BACK PAIN IN THE PAST 12 MONTHS
painarms	R HAD PAIN IN THE ARMS IN THE PAST 12 MONTHS
hurtatwk	NUMBER OF INJURIES ON THE JOB PAST 12 MONTHS
satjob1		JOB SATISFACTION IN GENERAL
workfor		R WORK FOR WHOM
ownstock	R HAS STOCK IN RS COMPANY
stockval	TOTAL DOLLAR VALUE OF RS STOCK
stockops	R HOLD ANY STOCK OPTIONS OF RS COMPANY
extrapay	ELIGIBLE FOR PERFORMANCE BASED PAY
compperf	SIZE OF PERF BASED PAY DEPEND ON PROFITS
deptperf	SIZE OF PERF BASED PAY DEPEND ON WORKGROUP
indperf		SIZE OF PERF BASED PAY DEPEND ON INDIVIDUAL
extraval	TOTAL DOLLAR VALUE OF PAY IN 2001
extrayr		YEAR OF THE MOST RECENT PERF BASED PAYMENTS
yearval		TOTAL DOLLAR VALUE OF PAYMENTS IN THAT YEAR
seecowrk	HOW EASY TO SEE WHETHER CO-WORKERS WORKING
cowrkhrd	HOW HARD TO SAY HOW PEOPLE WORK AT WORKPLACE
talkemp		HOW LIKELY TO TALK DIRECTLY IF COWORKER NOT WORK
talksup		HOW LIKELY TO SPEAK SUPERVISOR IF COWORKER NOT W
donothng	HOW LIKELY TO DO NOTHING IF COWORKER NOT WORKING
numemps		NUMBER OF EMPLOYEE FOR THE SELF-EMPLOYED
relneg		ANY TURNING POINT WHEN LESS COMMITTED TO RELIGION
newsfrom	MAIN SOURCE OF INFORMATION ABOUT EVENTS IN THE NEWS
scifrom		MAIN SOURCE OF INFORMATION ABOUT SCIENCE AND TECHNOLOGY
seeksci		PROBABLE SOURCE OF INFORMATION ABOUT SCIENTIFIC ISSUES
nextgen		SCIENCE & TECH. GIVE MORE OPPORTUNITIES TO NEXT GENERATION
toofast		SCIENCE MAKES OUR WAY OF LIFE CHANGE TO FAST
advfront	SCI RSCH IS NECESSARY AND SHOULD BE SUPPORTED BY FEDERAL GOVT
scispec		SCIENCE IS TOO CONCERNED WITH THEORY AND SPECULATION
leadsci		SHLD PAY ATTNTN ONLY TO THEORY ACCEPTED BY LEADING SCIENTISTS
whichsci	INDUSTRY SCIENTISTS LESS RELIABLE THAN UNIVERSITY SCIENTISTS
astrolgy	EVER READ A HORSCOPE OR PERSOANL ASTROLOGY REPORT
astrosci	ASTROLOGY IS SCIENTIFIC
scibnfts	BENEFITS OF SCI RESEARCH OUTWEIGHT HARMFUL RESULTS
balpos		SCI RESEARCH IS STRONGLY IN FAVOR OF BENEFITS
balneg		SCI RESEARCH IS STRONGLY IN FAVOR OF HARFUL RESULTS
scistudy	R HAS CLEAR UNDERSTANDING OF SCIENTIFIC STUDY
scitext		WHAT IT MEANS TO R TO STUDY STH SCIENFICALLY
expdesgn	BETTER WAY TO TEST DRUG BTW CONTROL AND NON-CONTROL
exptext		WHY IS IT BETTER TO TEST DRUG THIS WAY
odds1		TEST OF KNOWLEDGE ABOUT PROBABLITY1
odds2		TEST OF KNOWLEDGE ABOUT PROBABLITY2
hotcore		SCI KNOWLEDGE: THE CENTER OF EARTH IS VERY HOT
radioact	SCI KNOWLEDGE:ALL  RADIOACTIVITY IS MAN-MADE
boyorgrl	SCI KNOWLEDGE:FATHER GENE DECIDES SEX OF BABY
lasers		SCI KNOWLEDGE:LASERS WORK BY FOCUSING SOUND WAVES
electron	SCI KNOWLEDGE:ELECTRONS ARE SMALLER THAN ATOMS
viruses		SCI KNOWLEDGE:ANTIVIOTICS KILL VIRUSES AS WELL AS BACTERIA
bigbang		SCI KNOWLEDGE:THE UNIVERSE BEGAN WITH A HUGE EXPLOSION
condrift	SCI KNOWLEDGE:THE CONTINENTS HAVE BEEN MOVING
evolved		SCI KNOWLEDGE:HUMAN BEINGS DEVELOPED FROM ANIMALS
earthsun	SCI KNOWLEDGE:THE EARTH GOES AROUND THE SUN
solarrev	SCI KNOWLEDGE:HOW LONG THE EARTH GOES AROUND THE SUN
intrhome	INTERNET ACCESS IN R'S HOME
coldeg1		THE HIGHEST DEGREE R HAVE EARNED
majorcol	THE FIELD OF DEGREE R EARNED
colsci		R HAS TAKEN ANY COLLEGE-LEVEL SCI COURSE
colscinm	NUMBER OF COLLEGE-LEVEL SCI COURSES R HAVE TAKEN
hsmath		THE HIGHEST LEVEL OF MATH R COMPLETED IN HIGH SCHOOL
hsbio		R EVER TOOK A HIGH SCHOOL BIOLOGY COURSE
hschem		R EVER TOOK A HIGH SCHOOL CHEMISTRY COURSE
hsphys		R EVER TOOK A HIGH SCHOOL PHYSICS COURSE
gwsci		UNDERSTANDING OF GLOBAL WARMING BY ENVIRONMNT SCIENTISTS
gwpol		UNDERSTANDING OF GLOBAL WARMING BY ELECTED OFFICIALS
gwbiz		UNDERSTANDING OF GLOBAL WARMING BY BUSINESS LEADERS
sciagrgw	EXTENT OF AGREEMENT ON GLOBAL WARMING AMG ENV SCIENTISTS
sciinfgw	INFLUENCE ON GLOBAL WARMING POLICY:ENVIRONMNTAL SCIENTISTS
polinfgw	INFLUENCE ON GLOBAL WARMING POLICY:ELECTED OFFICIAL
bizinfgw	INFLUENCE ON GLOBAL WARMING POLICY:BUSINESS LEADER
scibstgw	BEST POLICY VS NARROW INTEREST:ENVIRONMENTAL SCIENTIST
polbstgw	BEST POLICY VS NARROW INTEREST:ELECTED OFFICIAL
bizbstgw	BEST POLICY VS NARROW INTEREST:BUSINESS LEADER
gasregs		HOW MUCH R FAVOR REQUIRING TO MAKE CARS USING LESS GASOLINE
scmed		HOW WELL MEDICAL RESEARCHER UNDERSTAND STEM CELLS
screlig		HOW WELL RELIGIOUS LEADER UNDERSTAND STEM CELLS
scpol		HOW WELL ELECTED OFFICIAL UNDERSTAND STEM CELLS
medagrsc	AGREEMENT BY MED RESEARCHERS ON IMPORTANCE OF STEM CELL RSCH
medinfsc	INFLUENCE ON FUNDING FOR STEM CELL RSCH:MEDICAL RESEARCHERS
relinfsc	INFLUENCE ON FUNDING FOR STEM CELL RSCH:RELIGIOUS LEADERS
polinfsc	INFLUENCE ON FUNDING FOR STEM CELL RSCH:ELECTED OFFICIALS
medbstsc	BEST POLICY ON STEM CELL VS NARROW INTEREST:MED RESEARCHER
relbstsc	BEST POLICY ON STEM CELL VS NARROW INTEREST:RELIG LEADER
polbstsc	BEST POLICY ON STEM CELL VS NARROW INTEREST:ELECTED OFFICIAL
scresrch	GOVERNMENT SHOULD FUND STEM CELL RESEARCH
txeco		HOW WELL ECONOMIST KNOW EFFECT OF REDUCING FED INCOME TAX
txbiz		HOW WELL BUSINESS LEADER KNOW EFFECT OF REDUCING FED INC TAX
txpol		HOW WELL ELECTED OFFICIAL KNOW EFFECT OF REDUCING FED INC TAX
ecoagree	AGREEMENT BY ECONOMISTS ON EFFECT OF REDUCING FED INC TAX
ecoinftx	INFLUENCE ON REDUING FED INC TAX  BY ECONOMISTS
bizinftx	INFLUENCE ON REDUING FED INC TAX  BY BUSINESS LEADERS
polinftx	INFLUENCE ON REDUING FED INC TAX  BY ELECTED OFFICIALS
ecobsttx	BEST POLICY VS NARROW INTEREST ON FED INC TAX:ECONOMIST
bizbsttx	BEST POLICY VS NARROW INTEREST ON FED INC TAX:BUSINESS LEADER
polbsttx	BEST POLICY VS NARROW INTEREST ON FED INC TAX:ELECTED OFFICIAL
gmmed		HOW WELL MED RESEARCHER KNOW RISK BY GENETICALLY MODIFIED FOODS
gmpol		HOW WELL ELECTED OFFICIAL KNOW RISK BY GENETICALLY MODIFIED FOODS
gmbiz		HOW WELL BUSINESS LEADER KNOW RISK BY GENETICALLY MODIFIED FOODS
medagrgm	MED RESEARCHER:AGREEMENT ON EFFECT OF GENETICALLY MODIFIED FOOD
medinfgm	INFLUENCE ON RESTRICTING GMF BY MEDICAL RESEARCHERS
polinfgm	INFLUENCE ON RESTRICTING GMF BY ELECTED OFFICIALS
bizinfgm	INFLUENCE ON RESTRICTING GMF BY BUSINESS LEADERS
medbstgm	BEST POLICY ON GMF VS NARROW INTEREST:MEDICAL RESEARCHER
polbstgm	BEST POLICY ON GMF VS NARROW INTEREST:ELECTED OFFICIAL
bizbstgm	BEST POLICY ON GMF VS NARROW INTEREST:BUSINESS LEADER
eatgm		R'S VIEW ABOUT EATING GENEFICALLY MODIFIED FOODS
sciimp1		HOW IMPORTANT:DONE BY SCIENTISTS IN UNIVERSITY SETTINGS
sciimp2		HOW IMPORTANT:HAVING ADVANCED DEGREES IN THEIR FIELDS
sciimp3		HOW IMPORTANT:CONCLUSION BASED ON SOLID EVIDENCE
sciimp4		HOW IMPORTANT:EXAMINING DIFFERENT INTERPRETATION OF RESULTS
sciimp5		HOW IMPORTANT:RESULTS CONSISTENT WITH RELIGIOUS BELIEFS
sciimp6		HOW IMPORTANT:RESULTS CONSISTENT WITH COMMON SENSE
sciimp7		HOW IMPORTANT:REPEATING EXPERIMENT & FINDING SAME RESULT
sciimp8		HOW IMPORTANT:RESEARCH TAKES PLACE IN A LABORATORY
socsci		HOW SCIENTIFIC: SOCIOLOGY
physcsci	HOW SCIENTIFIC: PHYSICS
histsci		HOW SCIENTIFIC: HISTORY
accntsci	HOW SCIENTIFIC: ACCOUNTING
biosci		HOW SCIENTIFIC: BIOLOGY
econsci		HOW SCIENTIFIC: ECONOMICS
medsci		HOW SCIENTIFIC: MEDICINE
engnrsci	HOW SCIENTIFIC: ENGINEERING
knwforgn	LEVEL OF R'S INFORMATION: FOREIGN POLICY
knwecon		LEVEL OF R'S INFORMATION: ECONOMIC POLICY
knwsci		LEVEL OF R'S INFORMATION: SCIENCE AND TECHNOLOGY
knwgw		LEVEL OF R'S INFORMATION: GLOBAL WARMING
knwpolar	LEVEL OF R'S INFORMATION: THE NORTH AND SOUTH POLES
tvbears		R WOULD CHOOSE TV PROGRAM ABOUT POLAR BEARS
tvinuit		R WOULD CHOOSE TV PROGRAM ABOUT NATIVE PPL IN THE ARCTIC
tvozone		R WOULD CHOOSE TV PROGRAM ABOUT OZONE HOLE OVER THE ANTARCTIC
tvmeltng	R WOULD CHOOSE TV PROGRAM ABOUT POLAR ICE MELTING
tvoil		R WOULD CHOOSE TV PROGRAM ABOUT OIL DRILLING IN THE ARCTIC
polaryr1	INTL POLAR YEAR 07-08:R WOULD WATCH A TV PROGRAM
polaryr2	INTL POLAR YEAR 07-08:R WOULD READ A NEWSPAPER ARTICLE
polaryr3	INTL POLAR YEAR 07-08:R WOULD READ A MAGAZINE ARTICLE
polaryr4	INTL POLAR YEAR 07-08:R WOULD GO TO MUSEUM
polaryr5	INTL POLAR YEAR 07-08:R WOULD WATCH A FEATURE FILM
polaryr6	INTL POLAR YEAR 07-08:R WOULD READ A BOOK
polaryr7	INTL POLAR YEAR 07-08:R WOULD VISIT A WEB SITE
polaryr8	INTL POLAR YEAR 07-08:R WOULD ATTEND A LIVE LECTURE
icesheet	TRUE-FALSE:THE NORTH POLE IS ON A SHEET OF ICE
nosun		TRUE-FALSE:THE SUN NEVER SHINES AT THE SOUTH POLE
inuit		TRUE-FALSE:INUIT LIVE NORTH OF THE ARCTIC CIRCLE
huntbear	TRUE-FALSE:HUNTING MAKE POLAR BEAR EXTINT THAN CLIMATE CHANGE
icecaps		POLAR ICE CAPS GOT LARGER OR SMALLER OVER LAST 25 YRS
comorsci	ANTARCTICA SHOULD BE RESERVED OR OPEN
extinct		EFFECT OF GLOBAL WARMING:POLAR BEARS BECOME EXTINCT
sealevel	EFFECT OF GLOBAL WARMING:SEE LEVEL FLOOD COASTAL AREAS
artseals	EFFECT OF GLOBAL WARMING:ARCTIC SEALS ARE THREATENED
inuitway	EFFECT OF GLOBAL WARMING:INUIT NO LONGER FOLLOW TRADITIONAL WAY OF LIFE
noicecap	EFFECT OF GLOBAL WARMING:NORTHERN ICE CAP MELT
caremost	MOST CONCERNED POSSIBLE EFFECT OF GLOBAL WARMING
nanotech	HOW MUCH R HEARD ABOUT NANOTECHNOLOGY
nanoknw1	TRUE-FALSE:NANOTECHNOLOGY MANIPULATE EXTREMELY SMALL UNITS
nanoknw2	TRUE-FALSE:NANOSCALE DIFFER FROM SAME MATERIAL AT LARGER SCALE
nanowill	BENEFIT OF NANOTECHNOLOGY OUTWEIGH HARMFUL RESULTS
buyvalue	PERCENT OF COMPANY STOCK R BOUGHT FROM OWN MONEY
ops2005		COMPANY GRANTED R STOCK OPTIONS IN 2005
extr2005	RECEIVED PERFORMANCE BASED PAYMENT IN 2005
compwage	ANNUAL WAGES IN 2005 WERE HIGHER THAN SAME JOBS IN OTHER COMPANIES
talkteam	IF EMPLOYEE NOT WORKING: TALK DIRECTLY TO THE EMPLOYEE
numorg		NUMBER OF PEOPLE WORKING IN ORGANIZATION AT ALL LOCATIONS
empinput	R INVOLVED IN ANY TASK FORCE FOR DECISION-MAKING
slfmangd	R INVOLVED IN A SELF-MANAGED TEAM
emptrain	RECEIVED FORMAL TRAINING FROM EMPLOYER
wealth		TOTAL WEALTH OF RESPONDENT
viglab06	X IS EXPERIENCING ALCHL DEPENDENCE  DEPRESSION SCHIZOPHRENIA
mhtrtoth	R PERSONALLY HAS KNOWN SOMEONE WHO RECEIVED TREATMENT
mhothyou	HOW MUCH DISTRESS HIS MENTAL HEALTH PROBLEM CAUSED R
mhothrel	RESULT OF MENTAL HEALTH PROBLEM TO RELATIONSHIP WITH HIM
seemhpub	HOW FREQUENTLY R SEES SOMEONE MENTALLY ILL IN PUBLIC
gesttalk	HOW OFTEN R SEE PEOPLE MAKING STRANGE GESTURE IN PUBLIC
avoidmh		R CHANGED SHOPPING PLACE DUE TO PRESENCE OF MENTALL ILL PPL
numknown	VARIABLE THAT DRIVES SKIPS IN MODULE
acqkevin	NUMBER OF KEVIN R IS ACQUAINTED WITH
acqkaren	NUMBER OF KAREN R IS ACQUAINTED WITH
acqlaws		NUMBER OF LAWYER R IS ACQUAINTED WITH
acqshawn	NUMBER OF SHAWN R IS ACQUAINTED WITH
acqbrnda	NUMBER OF BRENDA R IS ACQUAINTED WITH
acqsocs		NUMBER OF SOCIAL WORKER R IS ACQUAINTED WITH
acqkeith	NUMBER OF KEITH R IS ACQUAINTED WITH
acqchild	NUMBER OF CHILD CARE WORKER R IS ACQUAINTED WITH
acqrachl	NUMBER OF RACHEL R IS ACQUAINTED WITH
acqmark		NUMBER OF MARK R IS ACQUAINTED WITH
acqreps		NUMBER OF REPUBLICAN R IS ACQUAINTED WITH
acqlinda	NUMBER OF LINDA R IS ACQUAINTED WITH
acqmils		NUMBER OF PPL IN MILITARY SERVICE R IS ACQUAINTED WITH
acqjose		NUMBER OF JOSE R IS ACQUAINTED WITH
acqmyrac	PROPORTION OF SAME RACE AS R AMONG ALL AQUAINTANCES
acqmaria	NUMBER OF MARIA R IS ACQUAINTED WITH
acqnhasn	NUMBER OF ASIAN IN NEIGHBORHOOD
acqunemp	NUMBER OF PPL CURRENTLY UNEMPLOYED R IS ACQUAINTED WITH
acqnhblk	NUMBER OF BLACK IN NEIGHBORHOOD
acqhome		NUMBER OF PPL OWNING SECOND HOME R IS ACQUAINTED WITH
acqnhcoh	NUMBER OF COHABITING PPL IN NEIGHBORHOOD
acqprisn	NUMBER OF PPL IN PRISON R IS ACQUAINTED WITH
acqvaasn	NUMBER OF ASIAN IN VOLUNTARY ASSOCIATION
acqasian	NUMBER OF ASIAN R IS ACQUAINTED WITH
acqvablk	NUMBER OF BLACK IN VOLUNTARY ASSOCIATION
acqblack	NUMBER OF BLACK R IS ACQUAINTED WITH
acqjans		NUMBER OF JANITOR R IS ACQUAINTED WITH
acqhisp		NUMBER OF HISPANIC R IS ACQUAINTED WITH
acqnhgay	NUMBER OF GAY IN NEIGHBORHOOD
acqwhite	NUMBER OF WHITE R IS ACQUAINTED WITH
acqnhcon	NUMBER OF CONSERVATIVE IN NEIGHBORHOOD
acqvacoh	NUMBER OF COHABITING PPL IN VOLUNTARY ASSOCIATION
acqgay		NUMBER OF GAY R IS ACQUAINTED WITH
acqattnd	NUMBER OF RELUGAR CHURCH ATTENDEE R IS ACQUAINTED WITH
acqnhgo		NUMBER OF REGULAR CHURCH ATTENDEE IN NEIGHBORHOOD
acqcohab	NUMBER OF COHABITING PPL  R IS ACQUAINTED WITH
acqvacon	NUMBER OF CONSERVATIVE IN VOLUNTARY ASSOCIATION
acqnhhme	NUMBER OF PPL OWNING SECOND HOME IN NEIGHBORHOOD
acqgoatt	NUMBER OF REGULAR CHURCH ATTENDEE R IS ACQUAINTED WITH
acqvagay	NUMBER OF GAY IN VOLUNTARY ASSOCIATION
acqnhhsp	NUMBER OF HISPANIC IN NEIGHBORHOOD
acqnoatt	NUMBER OF NON CHURCH ATTENDEE R IS ACQUAINTED WITH
acqvago		NUMBER OF REGULAR CHURCH ATTENDEE IN VOLUNTARY ASSOCIATION
acqnhlib	NUMBER OF LIBERAL IN NEIGHBORHOOD
acqlib		NUMBER OF STRONG LIBERAL R IS ACQUAINTED WITH
acqvahme	NUMBER OF PPL OWNING SECOND HOME IN VOLUNTARY ASSOCIATION
acqnhlin	NUMBER OF LINDA IN NEIGHBORHOOD
acqcon		NUMBER OF STRONG CONSERVATIVE R IS ACQUAINTED WITH
acqwkasn	NUMBER OF ASIAN IN CURRENT OR PREVIOUS WORK
acqvahsp	NUMBER OF HISPANIC IN VOLUNTARY ASSOCIATION
acqnhmrk	NUMBER OF MARK IN NEIGHBORHOOD
acqwkblk	NUMBER OF BLACK IN CURRENT OR PREVIOUS WORK
acqvalib	NUMBER OF LIBERAL IN VOLUNTARY ASSOCIATION
acqvalin	NUMBER OF LINDA IN VOLUNTARY ASSOCIATION
acqwkcoh	NUMBER OF COHABITING PPL IN CURRENT OR PREVIOUS WORK
acqwkcon	NUMBER OF STRONG CONSERVATIVE IN CURRENT OR PREVIOUS WORK
acqnhno		NUMBER OF NON CHURCH ATTENDEE IN NEIGHBORHOOD
acqnhpri	NUMBER OF PPL IN PRISON IN NEIGHBORHOOD
acqvamrk	NUMBER OF MARK IN VOLUNTARY ASSOCIATION
acqnhune	NUMBER OF PPL UNEMPLOYED IN NEIGHBORHOOD
acqwkgay	NUMBER OF GAY IN CURRENT OR PREVIOUS WORK
acqvano		NUMBER OF NON CHURCH ATTENDEE IN VOLUNTARY ASSOCIATION
acqwkgo		NUMBER OF REGULAR CHURCH ATTENDEE IN CURRENT OR PREVIOUS WORK
acqcops		NUMBER OF POLICE OFFICER R IS ACQUAINTED WITH
acqnhwht	NUMBER OF WHITE IN NEIGHBORHOOD
acqvapri	NUMBER OF PPL IN PRISON IN VOLUNTARY ASSOCIATION
acqwkhme	NUMBER OF PPL OWNING SECOND HOME IN CURRENT OR PREVIOUS WORK
acqdems		NUMBER OF DEMOCRAT R IS ACQUAINTED WITH
acqvaune	NUMBER OF UNEMPLOYED PPL IN VOLUNTARY ASSOCIATION
acqwkhsp	NUMBER OF HISPANIC IN CURRENT OR PREVIOUS WORK
acqelecs	NUMBER OF ELECTRICIAN R IS ACQUAINTED WITH
acqvawht	NUMBER OF WHITE IN VOLUNTARY ASSOCIATION
acqwklib	NUMBER OF STRONG LIBERAL IN CURRENT OR PREVIOUSWORK
acqfmasn	NUMBER OF ASIAN FAMILY MEMBER
acqwklin	NUMBER OF LINDA IN CURRENT OR PREVIOUS WORK
acqfmblk	NUMBER OF BLACK FAMILY MEMBER
acqwkmrk	NUMBER OF MARK IN CURRENT OR PREVIOUS WORK
acqfmcoh	NUMBER OF COHABITING FAMILY MEMBER
acqwkno		NUMBER OF NON CHURCH ATTENDEE IN CURRENT OR PREVIOUS WORK
acqfmcon	NUMBER OF CONSEVATIVE IN FAMILY MEMBER
acqwkpri	NUMBER OF PPL IN PRISON IN CURRENT OR PREVIOUS WORK
acqfmgay	NUMBER OF GAY FAMILY MEMBER
acqwkune	NUMBER OF PPL UNEMPLOYED IN CURRENT OR PREVIOUS WORK
acqfmgo		NUMBER OF FAMILY MEMBER GOING CHURCH REGULARLY
acqwkwht	NUMBER OF WHITE IN CURRENT OR PREVIOUS WORK
acqfmhme	NUMBER OF FAMILY MEMBER OWNING SECOND HOME
acqfmhsp	NUMBER OF HISPANIC FAMILY MEMBER
acqfmlib	NUMBER OF LIBERAL IN FAMILY MEMBER
acqfmlin	NUMBER OF FAMILY MEMBER NAMED LINDA
acqfmmrk	NUMBER OF FAMILY MEMBER NAMED MARK
acqfmno		NUMBER OF FAMILY MEMBER NOT GOING CHURCH
acqfmpri	NUMBER OF FAMILY MEMBER IN PRISON
acqfmune	NUMBER OF UNEMPLOYED FAMILY MEMBER
acqfmwht	NUMBER OF WHITE FAMILY MEMBER
gunsales	SHOULD BACKGROUND CHECK BE REQUIRED FOR PRIVATE GUN SALE
gunsdrug	SHOULD PENALITY FOR ILLEGAL GUN SALE BE TOUGHER THAN DRUG
semiguns	SHOULD SEMI-AUTO GUN SALE BE LIMITED TO MILITARY
guns911		SHOULD GUN CONTROL LAW BE STRICTER AFTER 911
rifles50	SHOULD HIGH POWER RIFLE SALE BE LIMITED TO MILITARY
othguns		NUMBER OF ADULT OWING A GUN IN HOUSEHOLD
gunsdrnk	SHOULD CARRYING A FIREARM DRINKING ALCOHOL BE ILLEGAL
spnatdis	SHOULD GOVT SPEND MORE OR LESS ON NATURAL DISASTERS
natdisin	SHOULD HELPING PPL IN NATURAL DISASTER BE GOVT RESP
natdiscm	SHOULD REBUILDING COMMUNITY IN DISASTER BE GOVT RESP
newsprnt	HOW OFTEN DOES R READ TRADITIONAL NEWSPAPER
getaheay	OPINION OF WHY PEOPLE GET AHEAD
disabld1	R HAS A HEARING PROBLEM
disabld2	R HAS A VISION PROBLEM
disabld3	R HAS A PHYSICAL DISABILITY
disabld4	R HAS OTHER PHYSICAL DISABILITY
disabld5	R HAS EMOTIONAL OR MENTAL DISABILITY
disabld6	R HAS DIFFICULTY IN LEARNING REMEMBERING OR CONCENTRATING
disabld7	R HAS DIFFICULTY IN DAILY ACTIVITIES
vigvermy	VIGNETTE VERSION
mhproblm	How serious X s situation is
mhdofam		What X should do:Talk to Family
mhdofrnd	What X should do:Talk to Friends
mhdorel		What X should do:Talk to Relig Leader
mhdodoc		What X should do:Go to Doctor
mhdopsyc	What X should do:Go to Psychiatrist
mhdomhp		What X should do:Go to Counselor
mhdoheal	What X should do:Go to Spritual Healer
mhdootc		What X should do:Take Non-Prescription Medication
mhdorx		What X should do:Take Prescription Medication
mhdohosp	What X should do:Check into a Hospital
mhdopray	What X should do:Pray
mhdolife	What X should do:Change Lifestyle
mhdoherb	What X should do:Take Herbs
mhdofrgt	What X should do:Try to Forget
mhdoactv	What X should do:Get Involved in Other Activities
mhdogrp		What X should do:Get Involved in a Group
mhdodiet	What X should do:Eat Better
mhdoexrc	What X should do:Start Exercising
mhdomove	What X should do:Move to Another Location
mhdooth		What X should do:Other Mentions
mhdonone	What X should do:Nothing
mhchrctr	X s stuation caused by: Bad Character
mhbrain		X s stuation caused by: Brain Disease
mhraised	X s stuation caused by: the Way Raised
mhstress	X s stuation caused by: Stress
mhgenes		X s stuation caused by: Genetic Problem
mhgod		X s stuation caused by: God s Will
mhluck		X s stuation caused by: Bad Luck
mhupdown	X is experiencing Normal Ups-and-Downs of Life
mhillnss	X is experiencing Mental Illness
mhphyscl	X is experiencing Physical Illness
mhneihbr	R Would Have X as a Neighbor
mhsocial	R Would Spend Time Socializing with X
mhkdcare	R Would Have X Care for Your Children
mhfriend	R Would Make Friends with X
mhwkwith	R Would Work Closely with X on a Job
mhwedrel	R Would have X Marry Someone Related to You
mhimpown	How Likely X s Situation will improve on its own
mhimptrt	How Likely X s Situation will improve with treatment
mhdecslf	How Able Is X to Decide Whether to Receive Treatment
mhmoney		How Able Is X to Decide on Managing Own Money
mhoutsdr	Getting Treatment would Make X Outsider in Community
mhlosefr	X would Lose Friends if People Know his her Treatment
mhlessop	X s Opportunities Limited if people Know his her Treatment
mhuneasy	Being around X would Make Me Feel Uncomfortable
mhunsure	People like X are Unpredictable
mhintl		People like X are just as Intelligent as Anyone else
mhnotpol	People like X shldn t be Allowed to Hold Public Office
mhhrdtlk	People like X are Hard to Talk to
mhnokids	People like X shldn t be Allowed to Have Children
mhcreatv	People like X are More Creative than Others
mhnervs		Being around X would Make Me Feel Nervous
mhprdctv	People like X are just as Productive as Others
mhfeelem	X should Feel Embarrassed
mhtrusty	People like X are just as Trustworthy as Anyone else
mhaccptd	Person like X has no Hope of Being Accepted as Member
mhhired		X should be Hired like Others
mhnotell	X should Feel Afraid to Tell about his Situation
mhsecret	X s Family Better Off if Kept Secret
mhsupwrk	People like X shldn t be Allowed to Supervise Others at Work
mhnotch		People like X shldn t be Allowed to Teach Children.
mhhlpfam	How Important: Turn to Family for Help
mhhlpfrd	How Important: Turn to Friends for Help
mhhlprel	How Important: Turn to Religious Leader
mhhlpgp		How Important: Go to Medical Doctor for Help
mhhlppsy	How Important: Go to Psychiatrist for Help
mhhlpmhp	How Important: Go to Mental Health Professional
mhgvtjob	Govt Responsibility: Provide Job for X
mhgvthlt	Govt Responsibility: Provide Health Care for X
mhgvthme	Govt Responsibility: Provide Housing for X
mhgvtedc	Govt Responsibility: Provide Financial Help for Education
mhgvtdis	Govt Responsibility: Provide Disability Benefits for X
mhslfshm	X should be Ashamed to Receive Govt Assistance
mhfamshm	X Family should be Ashamed to Receive Govt Assistance
mhseedoc	X Should be Forced to be Examined at a Clinic by Law
mhmeds		X Should be Forced to Take Prescribed Medication by Law
mhhsptrt	X should be Forced to be Hospitalized for Treatment by Law
mhmnthsp	X should be Forced to Go to Mental Hospital by Law
mhviooth	How Likely X Violent toward Other People
mhvioslf	How Likely X Violent toward Him Herself
mhcause		What Caused X s Situation
mhtrtot2	R Knows Someone who Received Treatment for Mental Health
mhclsoth	Closeness to Person with Mental Health Problem
mhseroth	How Serious his her Mental Health Problem was
mhhlpoth	How the Treatment Helped him/her with Mental Health Problem
mhresoth	How Much ResponsibiIity R had for this person
mhdisoth	How Much Distress this person caused R
mhreloth	Relationship with this person as a result of Mental Health Problem
mhexpoth	Effect of Experiences with this person
mhtrtslf	R Have ever personally received treatment for mental health problem
mhseepub	How often R sees someone with mental health problem in public places
mhfright	How frightening most people are in public places
mhsymp		How much R feels sympathy for ppl with mental hlth problm in public places
obeylaw		SHOULD PEOPLE OBEY LAWS WITHOUT EXCEPTN?
protest1	ALLOW PUBLIC MEETINGS PROTESTING GOVT.
protest3	ALLOW DEMONSTRATIONS PROTESTING GOVT.
protest6	ALLOW NATIONAL ANTI-GOVT STRIKE.
revspeak	ALLOW REVOLUTIONARY PUBLIC MEETINGS.
revpub		ALLOW REVOLUTIONARIES TO PUBLISH BOOKS.
verdict		WORSE TYPE OF JUDICIAL MISTAKE.
databank	COMPUTER DATA THREAT TO INDIVIDL PRIVACY
poleff3		AVG PERSON CAN INFLUENCE POLITICIANS.
cutgovt		CUTS IN GOVT SPENDING.
makejobs	GOVT CREATE NEW JOBS.
lessreg		LESS GOVT REGULATION OF BUSINESS.
hlphitec	GOVT SUPPORT FOR NEW PRODUCTS AND TECH.
savejobs	GOVT SUPPORT FOR DECLINING INDUSTRIES.
cuthours	REDUCTION IN LENGTH OF WORK WEEK.
spenviro	GOVT SPENDING ON ENVIRONMENT.
sphlth		GOVT SPENDING ON HEALTH.
sppolice	GOVT SPENDING ON LAW ENFORCEMENT.
spschool	GOVT SPENDING ON EDUCATION.
sparms		GOVT SPENDING ON DEFENSE.
spretire	GOVT SPENDING ON RETIREMENT BENEFITS.
spunemp		GOVT SPENDING ON UNEMPLOYMENT BENEFITS.
sparts		GOVT SPENDING ON CULTURE AND THE ARTS.
jobsall		GOVTS RESP: PROVIDE JOBS FOR ALL.
pricecon	GOVTS RESP: KEEP PRICES UNDER CONTROL.
hlthcare	GOVTS RESP: PROVIDE HLTH CARE FOR SICK
aidold		GOVTS RESP: PROVIDE FOR THE ELDERLY.
aidindus	GOVTS RESP: ASSIST INDUSTRIAL GROWTH.
aidunemp	GOVTS RESP: PROVIDE FOR THE UNEMPLOYED.
equalize	GOVTS RESP: REDUCE INCOME DIFFERENCES.
aidcol		GOV. SHOULD ASSIST LOW-INCOME COLLEGE STUDENT
aidhouse	GOV. SHOULD PROVIDE HOUSING TO POOR
polint		YOUR INTEREST IN POLITICS.
grnlaws		GOV RESP TO TO MAKE INDUSTRY LESS DAMAGING
poleff11	DON'T HAVE ANY SAY ABOUT WHAT THE GOVERNMENT DOES
poleff13	HAVE A PRETTY GOOD UNDERSTANDING OF ISSUES
poleff15	MOST PEOPLE BETTER INFORMED ABOUT POLITICS THAN I
poleff16	PEOPLE ELECTED TO CONGRESS TRY TO KEEP PROMISES
poleff17	MOST GOVERNMENT ADMINISTRATORS CAN BE TRUSTED
posslq		DOES R HAVE MARITAL PARTNER
goodlife	STANDARD OF LIVING OF R WILL IMPROVE
taxrich		TAXES ON HIGH INCOME PEOPLE TOO HIGH
taxmid		TAXES ON MIDDLE INCOME PEOPLE TOO HIGH
taxpoor		TAXES ON LOW INCOME PEOPLE TOO HIGH
marhomo		HOMOSEXUALS SHOULD HAVE RIGHT TO MARRY
meovrwrk	MEN HURT FAMILY WHEN FOCUS ON WORK TOO MUCH
timepdwk	TIME R WOULD SPEND ON PAID WORK
timehhwk	TIME R WOULD SPEND ON HOUSEHOLD WORK
timefam		TIME R WOULD SPEND ON FAMILY
timefrnd	TIME R WOULD SPEND ON FRIENDS
timeleis	TIME R WOULD SPEND ON LEISURE
wrkearn		JOB IS JUST A WAY TO EARN MONEY
wrkenjoy	ENJOY JOB EVEN IF $ NOT NEEDED
secjob		IMPORTANCE OF JOB SECURITY IN A JOB
hiinc		IMPORTANCE OF HIGH PR INCOME IN A JOB
promotn		IMPORTANCE OF ADVANCEMENT IN A JOB
intjob		IMPORTANCE OF INTERESTING WORK IN A JOB
wrkindp		IMPORTANCE OF INDEPENDENT WORK IN A JOB
hlpoths		IMPORTANCE OF HELPING OTHERS IN A JOB
hlpsoc		IMPORTANCE OF SOCIAL USEFULNESS IN A JOB
flexhrs		IMPORTANCE OF FLEXIBLE HRS. IN A JOB
empself		DOES R PREFER SELF-EMPLOYMENT OR NOT ?
smallbig	R PREFERENCE RE: FIRM SIZE IN
privgovt	R PREFERENCE RE: PRIVATEPUBLIC SECTOR
hrsmoney	R PREFERENCE RE: WORK HRS AND MONEY
rsecjob		RS JOB IS SECURE
rhiinc		RS INCOME IS HIGH
rpromotn	R HAS OPPORTUNITY TO ADVANCE
rintjob		RS JOB IS INTERESTING
rwrkindp	R CAN WORK INDEPENDENTLY
rhlpoths	R HELPS OTHERS IN JOB
rhlpsoc		RS JOB IS USEFUL TO SOCIETY
xhaustn		HOW OFTEN DOES WORK EXHAUST R
physwrk		HOW OFTEN MUST R DO PHYSICAL WORK
stress		HOW OFTEN DOES R FIND WORK STRESSFUL
danger		HOW OFTEN DOES R WORK IN DANGEROUS CONDS
bossemps	QUALITY OF MGMNTEMPLOYEE RELS: RS FIRM
cowrkers	QUALITY OF RELS AMONG WORKERS: RS FIRM
jobsat		HOW SATISFIED IS R WITH HISHER JOB
localnum	NUMBER OF EMPLOYEES: RS WORK SITE
wantjob1	WHICH JOB WOULD YOU PREFER
sethours	WHO SET WORKING HOURS
useskill	HOW MUCH PAST SKILLS CAN YOU MAKE USE IN PRESENT
helporg1	WILLING TO WORK HARDER FOR THE FIRM
prideorg	I AM PROUD WORKING FOR MY FIRM
stayorg3	I WOULD TURN DOWN JOB OFFERING MORE PAY
leavejob	HOW LIKELY WILL TRY TO FIND AONTHER FIRM
worryjob	DO YOU WORRY ABOUT LOSING JOB
evjob		HAVE YOU EVER HAD A PAID JOB FOR 1 YEAR OR+
yrjobend	WHEN DID YOUR LAST PAID JOB END
whyjbend	MAIN REASON YOUR JOB END
wantjob2	WOULD LIKE TO HAVE A JOB NOW OR IN THE FUTURE
getjob		HOW LIKELY YOU WOULD FIND A JOB
lookjob		ARE YOU LOOKING FOR A JOB
pubagncy	REGISTERED AT A PUBLIC EMPLOYMENT AGANCY
priagncy	REGISTERED AT A PRIVATE EMPLOYMENT AGANCY
wantads		ANSWERED ADVERTISEMENTS FOR JOBS
adforjob	ADVERTISED FOR A JOB IN NEWSPAPERS
appemps		APPLIED DIRECTLY TO EMPLOYERS
askhelp		ASKED RELATIVES FRIENDS COLLEAGUES TO HELP
econsup		MAIN SOURCE OF ECONOMIC SUPPORT
relexper	TURNING POINT IN LIFE FOR RELIGION
relactiv	HOW OFTEN DOES R TAKE PART IN RELIG ACTIVITIES
letin1		NUMBER OF IMMIGRANTS TO AMERICA NOWADAYS SHOULD BE
helphlth	HOW SUCCESSFUL IS GOVT:PROVIDING HLTH CARE FOR THE SICK
helpold		HOW SUCCESSFUL IS GOVT:DECENT STANDARD OF LIVING FOR THE OLD
helpsec		HOW SUCCESSFUL IS GOVT:DEALING WITH AMERICA S SECURITY
helpcrim	HOW SUCCESSFUL IS GOVT:CONTROLLING CRIME
helpemp		HOW SUCCESSFUL IS GOVT:FIGHTING UNEMPLOYMENT
helpenv		HOW SUCCESSFUL IS GOVT:PROTECTING ENVIRONMENT
wotrial		SHOULD AUTHORITIES HAVE RIGHT TO DETAIN THE SUSPECTED
tapphone	SHOULD AUTHORITIES HAVE RIGHT TO TAP PHONE CONVERSATION
stoprndm	SHOULD AUTHORITIES HAVE RIGHT TO SEARCH PPL IN THE STREET
fewtrsty	THERE ARE ONLY A FEW PEOPLE R CAN TRUST COMPLETELY
exploit		OTHER PEOPLE TAKE ADVANTAGE OF R IF NOT CAREFUL
youinflu	HOW OFTEN R IS ASKED TO HELP INFLUENCE IMPORTANT DECISION
hlpinflu	DOES R HAVE PEOPLE TO ASK TO INFLUENCE IMPORTANT DECISION
polsfair	OPINION OF FARINESS OF PUBLIC OFFICAL S TREATMENT
knowpols	PUBLIC OFFICAL S TREATMENT DEPENDS ON WHO THEY KNOW
corrupt1	OPINION OF CORRUPTION BY POLITICIAN
corrupt2	OPINION OF CORRUPTION BY GOVERNMENT ADMINISTRATORS
bribe		DOES R SEE PUBLIC OFFICIAL ASKING FOR A BRIBE IN LAST FIVE YEARS
peocntct	HOW MANY PEOPLE IN CONTACT IN A TYPICAL WEEKDAY
selfemp1	EMPLOYEE HAVE MORE JOB SECURITY THAN THE SELF-EMPLOYED
selfemp2	BEING EMPLOYEE INTERFERE MORE WITH FAMILY LIFE THAN SELF-EMPLOYMENT
unjobsec	UNIONS ARE VERY IMPORTANT FOR JOB SECURITY
unbetter	WORKING CONDITION WOULD BE MUCH WORSE WITHOUT UNIONS
curwkpay	IS R CURRENTLY WORKING FOR PAY
rimpskls	JOB GIVES R CHANCE TO IMPROVE SKILLS
dailywrk	HOW RS DAILY WORK IS ORGANIZED
timeoff		HOW DIFFICULT R TAKES AN HOUR OFF DURING WORKING HOURS
jbintfam	HOW OFTEN R FELL:DEMAND OF JOB INTERFERE WITH FAMILY LIFE
famintjb	HOW OFTEN R FELL:DEMAND OF FAMILY LIFE INTERFERE WITH JOB
newjob		HOW HELPFUL PRESENT WORK SKILL WOULD BE FOR NEW JOB
jbtrain		DID R HAVE ANY TRAINING TO IMPROVE JOB SKILL PAST 12 MONTHS
jobeasy		HOW EASY IF R FIND A JOB AS GOOD AS CURRENT ONE
replaceu	HOW EASY RS FIRM REPLACES R IF R LEFT
nounemp1	R WOULD ACCEPT JOB REQUIRING NEW SKILL TO AVOID UNEMPLOYMENT
nounemp2	R WOULD ACCEPT POSITION WITH LOWER PAY TO AVOID UNEMPLOYMENT
nounemp3	R WOULD ACCEPT TEMPORARY EMPLOYMENT TO AVOID UNEMPLOYMENT
nounemp4	R WOULD ACCEPT TRAVEL LONGER TO WORK TO AVOID UNEMPLOYMENT
otherwrk	DOES R HAVE ANY ADDITIONAL JOB
big5a1		R SEE ONESELF AS SOMEONE WHO IS RESERVED
big5b1		R SEE ONESELF AS SOMEONE WHO IS GENERALLY TRUSTED
big5c1		R SEE ONESELF AS SOMEONE WHO DOES A THOROUGH JOB
big5d1		R SEE ONESELF AS SOMEONE WHO IS RELAXED
big5e1		R SEE ONESELF AS SOMEONE WHO HAS AN ACTIVE IMAGINATION
big5a2		R SEE ONESELF AS SOMEONE WHO IS SOCIABLE
big5b2		R SEE ONESELF AS SOMEONE WHO TENDS TO FIND FAULT WITH OTHERS
big5c2		R SEE ONESELF AS SOMEONE WHO TENDS TO BE LAZY
big5d2		R SEE ONESELF AS SOMEONE WHO GETS NERVOUS EASILY
big5e2		R SEE ONESELF AS SOMEONE WHO HAS FEW ARTISTIC INTERESTS
skltrain	R HAD JOB SKILL TRAINING IN THE  PAST 12 MONTHS
spwrkgvt	SPOUSE WORKING FOR GOVERNMENT
partners	HOW MANY SEX PARTNERS R HAD IN LAST YEAR
matesex		WAS 1 OF RS PARTNERS SPOUSE OR REGULAR
frndsex		R HAD SEX WITH FRIEND LAST YEAR
acqntsex	R HAD SEX WITH ACQUAINTANCE LAST YEAR
pikupsex	R HAD SEX WITH CAUSUAL DATE LAST YEAR
paidsex		R HAD SEX FOR PAY LAST YEAR
othersex	R HAD SEX WITH SOME OTHER LAST YEAR
sexsex		SEX OF SEX PARTNERS IN LAST YEAR
sexfreq		FREQUENCY OF SEX DURING LAST YEAR
numwomen	NUMBER OF FEMALE SEX PARTNERS SINCE 18
nummen		NUMBER OF MALE SEX PARTNERS SINCE 18
partnrs5	HOW MANY SEX PARTNERS R HAD IN LAST 5 YEARS
sexsex5		SEX OF SEX PARTNERS LAST FIVE YEARS
evpaidsx	EVER HAVE SEX PAID FOR OR BEING PAID SINCE 18
evstray		HAVE SEX OTHER THAN SPOUSE WHILE MARRIED
condom		USED CONDOM LAST TIME
relatsex	RELATION TO LAST SEX PARTNER
evidu		R EVER INJECT DRUGS
idu30		R INJECT DRUGS IN PAST 30 DAYS
evcrack		R EVER USE CRACK COCAINE
crack30		R LAST USE CRACK COCAINE
hivtest		Have you ever been tested for HIV
hivtest1	In what month and year was your last HIV test
hivtest2	Where did you have your last HIV test
realinc		FAMILY INCOME IN CONSTANT $
realrinc	RS INCOME IN CONSTANT $
ethnic		COUNTRY OF FAMILY ORIGIN
eth1		1ST MENTIONED COUNTRY OF ORIGIN
eth2		2ND MENTIONED COUNTRY OF ORIGIN
eth3		3RD MENTIONED COUNTRY OF ORIGIN
ethnum		TYPE OF RESPONSE ABOUT ETHNICITY -- R
hispanic	HISPANIC SPECIFIED
racecen1	WHAT IS RS RACE 1ST MENTION
racecen2	WHAT IS RS RACE 2ND MENTION
racecen3	WHAT IS RS RACE 3RD MENTION
dwelling	TYPE OF STRUCTURE
dwelown		DOES R OWN OR RENT HOME?
worda		WORD A
wordb		WORD B
wordc		WORD C
wordd		WORD D
worde		WORD E
wordf		WORD F
wordg		WORD G
wordh		WORD H
wordi		WORD I
wordj		WORD J
wordsum		NUMBER WORDS CORRECT IN VOCABULARY TEST
relate1		RELATIONSHIP OF 1ST PERSON TO HOUSEHOLD HEAD
gender1		GENDER OF 1ST PERSON
old1		AGE OF 1ST PERSON
mar1		MARITAL STATUS OF 1ST PERSON
away1		IS 1ST PERSON STAYING SOMEWHERE ELSE NOW?
where1		WHERE IS 1ST PERSON STAYING?
relate2		RELATIONSHIP OF 2ND PERSON TO HOUSEHOLD HEAD
gender2		GENDER OF 2ND PERSON
old2		AGE OF 2ND PERSON
mar2		MARITAL STATUS OF 2ND PERSON
away2		IS 2ND PERSON STAYING SOMEWHERE ELSE NOW?
where2		WHERE IS 2ND PERSON STAYING?
relate3		RELATIONSHIP OF 3RD PERSON TO HOUSEHOLD HEAD
gender3		GENDER OF 3RD PERSON
old3		AGE OF 3RD PERSON
mar3		MARITAL STATUS OF 3RD PERSON
away3		IS 3RD PERSON STAYING SOMEWHERE ELSE NOW?
where3		WHERE IS 3RD PERSON STAYING?
relate4		RELATIONSHIP OF 4TH PERSON TO HOUSEHOLD HEAD
gender4		GENDER OF 4TH PERSON
old4		AGE OF 4TH PERSON
mar4		MARITAL STATUS OF 4TH PERSON
away4		IS 4TH PERSON STAYING SOMEWHERE ELSE NOW?
where4		WHERE IS 4TH PERSON STAYING?
relate5		RELATIONSHIP OF 5TH PERSON TO HOUSEHOLD HEAD
gender5		GENDER OF 5TH PERSON
old5		AGE OF 5TH PERSON
mar5		MARITAL STATUS OF 5TH PERSON
away5		IS 5TH PERSON STAYING SOMEWHERE ELSE NOW?
where5		WHERE IS 5TH PERSON STAYING?
relate6		RELATIONSHIP OF 6TH PERSON TO HOUSEHOLD HEAD
gender6		GENDER OF 6TH PERSON
old6		AGE OF 6TH PERSON
mar6		MARITAL STATUS OF 6TH PERSON
away6		IS 6TH PERSON STAYING SOMEWHERE ELSE NOW?
where6		WHERE IS 6TH PERSON STAYING?
relate7		RELATIONSHIP OF 7TH PERSON TO HOUSEHOLD HEAD
gender7		GENDER OF 7TH PERSON
old7		AGE OF 7TH PERSON
mar7		MARITAL STATUS OF 7TH PERSON
away7		IS 7TH PERSON STAYING SOMEWHERE ELSE NOW?
where7		WHERE IS 7TH PERSON STAYING?
relate8		RELATIONSHIP OF 8TH PERSON TO HOUSEHOLD HEAD
gender8		GENDER OF 8TH PERSON
old8		AGE OF 8TH PERSON
mar8		MARITAL STATUS OF 8TH PERSON
relate9		RELATIONSHIP OF 9TH PERSON TO HOUSEHOLD HEAD
gender9		GENDER OF 9TH PERSON
old9		AGE OF 9TH PERSON
relate10	RELATIONSHIP OF 10TH PERSON TO HOUSEHOLD HEAD
gender10	GENDER OF 10TH PERSON
old10		AGE OF 1OTH PERSON
relate11	RELATION OF 11TH PERSON (VISITOR) TO HEAD
gender11	GENDER OF 11TH PERSON (VISITOR)
old11		AGE OF 11TH PERSON (VISITOR)
mar11		MARITAL STATUS OF 11TH PERSON (VISITOR)
away11		IS 11TH PERSON (VISITOR) STAYING ELSEWHERE NOW?
where11		WHERE IS 11TH PERSON (VISITOR) STAYING?
relate12	RELATION OF 12TH PERSON (VISITOR) TO HEAD
gender12	GENDER OF 12TH PERSON (VISITOR)
old12		AGE OF 12TH PERSON (VISITOR)
mar12		MARITAL STATUS OF 12TH PERSON (VISITOR)
away12		IS 12TH PERSON (VISITOR) STAYING ELSEWHERE NOW?
where12		WHERE IS 12TH PERSON (VISITOR) STAYING?
relate13	RELATION OF 13TH PERSON (VISITOR) TO HEAD
gender13	GENDER OF 13TH PERSON (VISITOR)
old13		AGE OF 13TH PERSON (VISITOR)
relate14	RELATION OF 14TH PERSON (VISITOR) TO HEAD
gender14	GENDER OF 14TH PERSON (VISITOR)
old14		AGE OF 14TH PERSON (VISITOR)
relhhd1		RELATION OF 1ST PERSON TO HOUSEHOLD HEAD
relhhd2		RELATION OF 2ND PERSON TO HOUSEHOLD HEAD
relhhd3		RELATION OF 3RD PERSON TO HOUSEHOLD HEAD
relhhd4		RELATION OF 4TH PERSON TO HOUSEHOLD HEAD
relhhd5		RELATION OF 5TH PERSON TO HOUSEHOLD HEAD
relhhd6		RELATION OF 6TH PERSON TO HOUSEHOLD HEAD
relhhd7		RELATION OF 7TH PERSON TO HOUSEHOLD HEAD
relhhd8		RELATION OF 8TH PERSON TO HOUSEHOLD HEAD
relhhd9		RELATION OF 9TH PERSON TO HOUSEHOLD HEAD
relhhd10	RELATION OF 1OTH PERSON TO HOUSEHOLD HEAD
relhhd11	RELATION OF 11TH PERSON (VISITOR) TO HEAD
relhhd12	RELATION OF 12TH PERSON (VISITOR) TO HEAD
relhhd13	RELATION OF 13TH PERSON (VISITOR) TO HEAD
relhhd14	RELATION OF 14TH PERSON (VISITOR) TO HEAD
hefinfo		NUMBER OF PEOPLE IN INFORMANT'S HOUSEHOLD
hhrace		RACE OF HOUSEHOLD
respnum		NUMBER IN FAMILY OF R
hhtype		HOUSEHOLD TYPE
hhtype1		HOUSEHOLD TYPE (CONDENSED)
famgen		NUMBER OF FAMILY GENERATIONS IN HOUSEHOLD
rplace		R'S RELATIONSHIP TO HOUSEHOLD HEAD
rvisitor	IS R A VISITOR?
visitors	NUMBER OF VISITORS IN HOUSEHOLD
relhh1		RELATIONSHIP OF PERSON 1 TO HEAD OF HOUSEHOLD
relhh2		RELATIONSHIP OF PERSON 2 TO HEAD OF HOUSEHOLD
relhh3		RELATIONSHIP OF PERSON 3 TO HEAD OF HOUSEHOLD
relhh4		RELATIONSHIP OF PERSON 4 TO HEAD OF HOUSEHOLD
relhh5		RELATIONSHIP OF PERSON 5 TO HEAD OF HOUSEHOLD
relhh6		RELATIONSHIP OF PERSON 6 TO HEAD OF HOUSEHOLD
relhh7		RELATIONSHIP OF PERSON 7 TO HEAD OF HOUSEHOLD
relhh8		RELATIONSHIP OF PERSON 8 TO HEAD OF HOUSEHOLD
relhh9		RELATIONSHIP OF PERSON 9 TO HEAD OF HOUSEHOLD
relhh10		RELATIONSHIP OF PERSON 10 TO HEAD OF HOUSEHOLD
relhh11		RELATIONSHIP OF PERSON 11 TO HEAD OF HOUSEHOLD
relhh12		RELATIONSHIP OF PERSON 12 TO HEAD OF HOUSEHOLD
relhh13		RELATIONSHIP OF PERSON 13 TO HEAD OF HOUSEHOLD
relhh14		RELATIONSHIP OF PERSON 14 TO HEAD OF HOUSEHOLD
relsp1		RELATIONSHIP OF PERSON 1 TO SPOUSE OF HOUSEHOL
relsp2		RELATIONSHIP OF PERSON 2 TO SPOUSE OF HOUSEHOL
relsp3		RELATIONSHIP OF PERSON 3 TO SPOUSE OF HOUSEHOL
relsp4		RELATIONSHIP OF PERSON 4 TO SPOUSE OF HOUSEHOL
relsp5		RELATIONSHIP OF PERSON 5 TO SPOUSE OF HOUSEHOL
relsp6		RELATIONSHIP OF PERSON 6 TO SPOUSE OF HOUSEHOL
relsp7		RELATIONSHIP OF PERSON 7 TO SPOUSE OF HOUSEHOL
relsp8		RELATIONSHIP OF PERSON 8 TO SPOUSE OF HOUSEHOL
relsp9		RELATIONSHIP OF PERSON 9 TO SPOUSE OF HOUSEHOL
relsp10		RELATIONSHIP OF PERSON 10 TO SPOUSE OF HOUSEHO
relsp11		RELATIONSHIP OF PERSON 11 TO SPOUSE OF HOUSEHO
relsp12		RELATIONSHIP OF PERSON 12 TO SPOUSE OF HOUSEHO
relsp13		RELATIONSHIP OF PERSON 13 TO SPOUSE OF HOUSEHO
relsp14		RELATIONSHIP OF PERSON 14 TO SPOUSE OF HOUSEHO
dateintv	DATE OF INTERVIEW
isco681		RESPONDENT'S OCCUPATION, 1980 CENSUS
paisc681	R'S FATHER'S OCCUPATION, 1980 CENSUS
maisc681	R'S MOTHER'S OCCUPATION, 1980 CENSUS
spisc681	R'S SPOUSE'S OCCUPATION, 1980 CENSUS
isco88		RESPONDENT'S OCCUPATION, 1988 CENSUS
paisco88	R'S FATHER'S OCCUPATION, 1988 CENSUS
maisco88	R'S MOTHER'S OCCUPATION, 1988 CENSUS
spisco88	R'S SPOUSE'S OCCUPATION, 1988 CENSUS
sei			RESPONDENT SOCIOECONOMIC INDEX
pasei		R'S FATHER'S SOCIOECONOMIC INDEX
masei		R'S MOTHER'S SOCIOECONOMIC INDEX
spsei		R'S SPOUSE'S SOCIOECONOMIC INDEX
uswary		EXPECT U.S. IN WORLD WAR IN 10 YEARS
usintl		TAKE ACTIVE PART IN WORLD AFFAIRS
cohort		YEAR OF BIRTH
zodiac		RESPONDENTS ASTROLOGICAL SIGN
inthisp		IS INTERVIEWER SPANISH, HISPANIC OR LATINO
intrace1	INTERVIEWER S RACE1
intrace2	INTERVIEWER S RACE2
intrace3	INTERVIEWER S RACE3
coninc		FAMILY INCOME IN CONSTANT DOLLARS
conrinc		RESPONDENT INCOME IN CONSTANT DOLLARS
whoelse1	PRESENCE OF OTHERS:CHILDREN UNDER SIX
whoelse2	PRESENCE OF OTHERS:OLDER CHILDREN
whoelse3	PRESENCE OF OTHERS:SPOUSE PARTNER
whoelse4	PRESENCE OF OTHERS:OTHER RELATIVES
whoelse5	PRESENCE OF OTHERS:OTHER ADULTS
whoelse6	PRESENCE OF OTHERS:NO ONE
saqsex		R DID SEX MODULE
intid		INTERVIEWER ID
feeused		FEE GIVEN TO GET CASE
lngthinv	HOW LONG WAS INTERVIEW
intage		AGE OF INTERVIEWER
intethn		RACE OF INTERVIEWER
mode		INTERVIEW DONE IN-PERSON OR OVER THE PHONE
intsex		SEX OF INTERVIEWER
feelevel	AMOUNT OF FEES PAID(GROUPED)
intyrs		YEARS OF SERVICE AS AN INTERVIEWER AT NORC
ballot		BALLOT USED FOR INTERVIEW
version		VERSION OF QUESTIONNAIRE
issp		FILTER FOR ISSP CASES
formwt		POST-STRATIFICATION WEIGHT
sampcode	SAMPLING ERROR CODE
sample		SAMPLING FRAME AND METHOD
oversamp	WEIGHTS FOR BLACK OVERSAMPLES
phase		Subsampling: two-phase design.
spanself	If this interview had only been available in English, would you
spanint		If no Spanish, R could have been interviewed in English
spaneng		Interviews Conducted in Spanish or English
wtss		WEIGHT VARIABLE
wtssnr		WEIGHT VARIABLE
wtssall		WEIGHT VARIABLE
